1111111111111111111111111
1000000000000000000000001
10P000000C000000000000001
1000000000000000000000001
1000000110000C00000000001
1000000110000000000000001
1010000000000000000000001
101000000000000000000E001
1010000000000000000000001
1111111111111111111111111