1111111111111111111111
1P00100000100000000001
1100100000100000000111
100010C000100011111111
1000000000100001000011
100C1000001C0000010001
1000000C00000000001101
1000100000000001110001
10000000000C01110000E1
1111111111111111111111