1111111111111111111111111
10000000000C0000000000001
100000P000000000000000C001
100000000000000E000000001
1111111111111111111111111